XXXXXXXXX
I____O_IX
X_XXXXXXX
X_X____IX
X_X____XX
I___XX_XX
X___X___X
XA__X__kX
XXXXXXXXX