XXXXXXXXXX
X___I_X__X
XXX_XXX__X
X_I_I_X__X
XXX_XXX__X
I___HG___X
I________X
XXX_XXXX_X
X_I_I_Xk_X
XXXXXXXXXX