XXXXXXXXX
I_A____kX
X_______X
X___*___X
X___O___X
X____O*_X
X_______X
X_______X
XXXXXXXXX