XXXXXXXXX
I___O__kX
X_______X
X_______X
X_______X
X_______X
X_____O_X
XA______X
XXXXXXXXX