XXXXXXXX
X___A__X
X_X_X__X
X__X___X
X_X_X__X
X______I
X____$OX
XXXXXXXX